index	Rank	Nation	Gold	Silver	Bronze	Total
0	1	Nigeria	13	5	6	24
1	2	South Africa	11	11	8	30
2	3	Ethiopia	6	3	2	11
5	6	Senegal	2	1	3	6
6	7	Ghana	2	0	4	6
7	8	Cameroon	1	4	1	6
8	9	Egypt	1	1	2	4
9	10	Mauritius	1	0	1	2
11	12	Algeria	0	8	1	9
12	13	Madagascar	0	2	1	3
13	14	Zimbabwe	0	1	1	2
19	18	Namibia	0	0	1	1
20	18	Ivory Coast	0	0	1	1
